wwwwwwwwwwwww
w.........A.w
w...w...w.w.w
w...w...ww+.w
w...w3..ww..w
w.......w...w
w.2.www.....w
w..g..1.w...w
wwwwwwwwwwwww
