wwwwwwwwwwwww
w..w..+....3w
w..w..w.....w
w....1w1....w
w...wwwww...w
w.........w.w
w..w..w..ww.w
wg....A.....w
wwwwwwwwwwwww
