wwwwwwwwwwwww
w..w....+..ww
w..w...www..w
w..www.....3w
w.A........ww
ww..w..www..w
w...w....w.gw
w.2.w.1..w..w
wwwwwwwwwwwww
