wwwwwwwwwwwww
w.3ww....A..w
w...........w
wg....wwwwwww
w..ww.....22w
wwwwwww.....w
w..ww....ww+w
w..2..w.....w
wwwwwwwwwwwww
