wwwwwwwwwwwww
w.....w.....w
wAww...w....w
w...w..w.g..w
w....w......w
w.ww...w....w
w.ww..2.w...w
w1w..+...ww.w
wwwwwwwwwwwww
