wwwwwwwwwwwww
w.3.....ww..w
w..w........w
w....ww1....w
w..+....wwA.w
w....ww..ww.w
w.ww.ww..w..w
w...3.....g.w
wwwwwwwwwwwww
