wwwwwwwwwwwww
w...........w
w...w...3...w
w...ww+ww...w
w.....wgw...w
w.www....w..w
w...ww...w..w
w..A...3....w
wwwwwwwwwwwww
