wwwwwwwwwwwww
w.....w....Aw
w....w......w
w.w.w..1..wgw
w+w.........w
w.w..w..w...w
w.......w...w
w...w.......w
wwwwwwwwwwwww
