wwwwwwwwwwwww
w....w....1gw
w....w......w
w.w.w..1...ww
w+w........ww
ww1..w..3...w
w..w..w.w...w
w...A.......w
wwwwwwwwwwwww
