wwwwwwwwwwwww
w..........gw
w....w......w
w.w....1w...w
w+w.........w
w.1..w..3w..w
w.......w.w.w
w...A.......w
wwwwwwwwwwwww
