wwwwwwwwwwwww
w..3.......Aw
w....w......w
w.w.w...wwwgw
w+w.........w
w.1..w.ww...w
w.......w.w.w
w...w.......w
wwwwwwwwwwwww
