wwwwwwwwwwwww
w....w.....gw
w....w......w
w.w....1w...w
w+w.........w
w.1..wwww.w.w
w.......w.w.w
w...A.......w
wwwwwwwwwwwww
