wwwwwwwwwwwww
w..........gw
w....w......w
w.w.w..1w..ww
w+w......wwww
ww1..w..w...w
w..w..w.w...w
w...A.......w
wwwwwwwwwwwww
