wwwwwwwwwwwww
w.3.gw....1.w
w..www......w
w...w......ww
w.........www
ww1..w..3+..w
w..w..w.w.w.w
w...A.......w
wwwwwwwwwwwww
