wwwwwwwwwwwww
w.3.g.....1.w
w..www......w
w...........w
w.......w...w
w.......w+..w
w...w.w.w...w
wA..w.......w
wwwwwwwwwwwww
