wwwwwwwwwwwww
w..........gw
w....w......w
w.w....1....w
w+w.........w
ww1..w.w3w..w
w.......w...w
w...Aw......w
wwwwwwwwwwwww
