wwwwwwwwwwwww
wA..g....w..w
w..w........w
w.......w.+ww
ww..ww..wwwww
w.......w.w.w
w.w.........w
w.....w.....w
wwwwwwwwwwwww
