wwwwwwwwwwwww
w..3..w....Aw
w....w......w
w.w.....ww.ww
w+w........1w
w.w..wwwwwwww
w.......w...w
w...ww....wgw
wwwwwwwwwwwww
