wwwwwwwwwwwww
w....w....1gw
w...ww......w
w.w.w......ww
w..........ww
www.....w+..w
w..w..w.w.w.w
w...A.......w
wwwwwwwwwwwww
