wwwwwwwwwwwww
w..........gw
w....w......w
w.w.....www.w
w+w........1w
ww1..wwwwww.w
w.......w...w
w...Aw....w.w
wwwwwwwwwwwww
