wwwwwwwwwwwww
wA.......w.gw
w..w........w
w...w...w.+.w
www.ww..w...w
w.......w...w
w.w.......w.w
w.....w.....w
wwwwwwwwwwwww
