wwwwwwwwwwwww
w..3.......Aw
w....w......w
w.w......wwgw
w+w.........w
w.1..wwwwww.w
w.......w...w
w...ww....w.w
wwwwwwwwwwwww
