wwwwwwwwwwwww
w..3..w....Aw
w....w......w
w.w.....wwwgw
w+w.........w
w.1..wwww.w.w
w.......w...w
w...w.....w.w
wwwwwwwwwwwww
