wwwwwwwwwwwww
wA.......w..w
w..w........w
w...w...w..ww
w+w..w..wwwww
ww......w.g.w
w...........w
w.....w.....w
wwwwwwwwwwwww
