wwwwwwwwwwwww
w.....w....gw
w....w......w
w.w.w..1....w
w+w.........w
w.1..w..3...w
w.......w.w.w
w...Aw......w
wwwwwwwwwwwww
