wwwwwwwwwwwww
wA.......w..w
w..w........w
w...w...w.+ww
www.ww...wwww
ww1.....w.g.w
w.ww..w...w.w
w.....w.....w
wwwwwwwwwwwww
