wwwwwwwwwwwww
w..........Aw
w....w......w
w.w.w..1...gw
w+w.........w
w.w..w.ww.w.w
w.......w...w
w...w.......w
wwwwwwwwwwwww
