wwwwwwwwwwwww
wA.......w..w
w..w........w
w...w...w.+ww
www.ww..www.w
www.....w.g.w
w.w.........w
w.....w.....w
wwwwwwwwwwwww
