wwwwwwwwwwwww
w.3.gw....1.w
w...ww......w
w...w......ww
w........wwww
ww......w+..w
w.......w...w
wA..w.......w
wwwwwwwwwwwww
