wwwwwwwwwwwww
w.....w....Aw
w....w......w
w.w.....wwwww
w+w........1w
ww1..wwwwwwww
w.......w...w
w...ww....wgw
wwwwwwwwwwwww
