wwwwwwwwwwwww
w.3.gw....1.w
w..www......w
w.........www
w.......wwwww
w.......w+w.w
w...w...w...w
wA..ww....w.w
wwwwwwwwwwwww
