wwwwwwwwwwwww
w..........Aw
w....w......w
w.w.w......gw
w+w........1w
w.1..w..www.w
w..w....w...w
w...ww......w
wwwwwwwwwwwww
