wwwwwwwwwwwww
wA3.g.....1.w
w..w........w
w..........ww
w...w...wwwww
w.......w+..w
w.w.....w...w
w...........w
wwwwwwwwwwwww
