wwwwwwwwwwwww
w..........gw
w...ww......w
w...w..1....w
w+..........w
ww...w..3...w
w..w..w.w.w.w
w...A.......w
wwwwwwwwwwwww
