wwwwwwwwwwwww
w.3.g.......w
w..www......w
w...w.......w
w.........www
ww......3+..w
w..w..w.w.w.w
w...A.......w
wwwwwwwwwwwww
