wwwwwwwwwwwww
wA.......w..w
w..w........w
w...w...w.+ww
www..w..wwwww
ww......w.g.w
w...........w
w...........w
wwwwwwwwwwwww
