wwwwwwwwwwwww
w..........Aw
w....w......w
w.w.w.....wgw
w+w........1w
w.w..w..w...w
w..w....w...w
w...w.......w
wwwwwwwwwwwww
