wwwwwwwwwwwww
w...g.....1.w
w...ww......w
w.w.w.......w
w.......w...w
www.....w+..w
w..w..w.w.w.w
w...A.......w
wwwwwwwwwwwww
