wwwwwwwwwwwww
w.3.g.......w
w...ww......w
w...........w
w.......w..ww
w.......w+..w
w...w...w.w.w
wA..w.......w
wwwwwwwwwwwww
