wwwwwwwwwwwww
w...g....w..w
w..w........w
w...w...w.+ww
w.......wwwww
w.......w.w.w
w...........w
wA..........w
wwwwwwwwwwwww
