wwwwwwwwwwwww
w...gw....1.w
w...ww......w
w...w......ww
w..........ww
ww......3+..w
w..w..w.w.w.w
w...A.......w
wwwwwwwwwwwww
