wwwwwwwwwwwww
wA..g....w..w
w..w........w
w.......w.+ww
ww..w...wwwww
w.......w...w
w.w.w.......w
w.....w.....w
wwwwwwwwwwwww
