wwwwwwwwwwwww
w.....w....Aw
w....w......w
w.w.w..1wwwgw
w+w........1w
w.w..w..w.w.w
w.......w...w
w...w.......w
wwwwwwwwwwwww
