wwwwwwwwwwwww
w..3..w....Aw
w....w......w
w.w.w...www.w
w+w........1w
w.w..w.wwww.w
w.......w...w
w...ww....wgw
wwwwwwwwwwwww
