wwwwwwwwwwwww
wA.......w.ww
w..w........w
w...w...w.+.w
www.ww..www.w
ww......w.g.w
w.w.........w
w.....w.....w
wwwwwwwwwwwww
