wwwwwwwwwwwww
w...g.....1.w
w...ww......w
w...w......ww
w.......w.www
ww......w+..w
w..w..w.w.w.w
w...A.......w
wwwwwwwwwwwww
