wwwwwwwwwwwww
w.....w....Aw
w....w......w
w.w.w.....wgw
w+w.........w
w.w..w..w.w.w
w..w....w...w
w...w.......w
wwwwwwwwwwwww
