wwwwwwwwwwwww
w....w.....gw
w....w......w
w.w.......w.w
w+w.........w
ww1..www3ww.w
w.......w...w
w...A.......w
wwwwwwwwwwwww
