wwwwwwwwwwwww
w....w....1gw
w....w......w
w.w.w......ww
w+.........ww
ww1.....3...w
w..w..w.w...w
w...A.......w
wwwwwwwwwwwww
