wwwwwwwwwwwww
w..3..w....Aw
w....w......w
w.w.......wgw
w+w.........w
w.1..www3ww.w
w.......w...w
w...ww......w
wwwwwwwwwwwww
