wwwwwwwwwwwww
w..........gw
w....w......w
w.w.........w
w+w.........w
w.1..w.wwww.w
w.......w.w.w
w...A.......w
wwwwwwwwwwwww
