wwwwwwwwwwwww
w........w..w
w..w.w......w
w.w.w...w..ww
w+w.....wwwww
ww1.....w.g.w
w..w........w
w...A.......w
wwwwwwwwwwwww
