wwwwwwwwwwwww
wA3..w......w
w..w........w
w...w...w.+ww
w...ww..wwwww
w.......w.g.w
w...........w
w.....w.....w
wwwwwwwwwwwww
