wwwwwwwwwwwww
w..3..w....Aw
w....w......w
w.w......w.gw
w+w.........w
w.w..www3w..w
w.......w...w
w...ww......w
wwwwwwwwwwwww
