wwwwwwwwwwwww
w...g.....w.w
w...ww......w
w...........w
w.......w.w.w
w.......w+..w
w...w...w...w
wA..w.......w
wwwwwwwwwwwww
