wwwwwwwwwwwww
w.3.g.....w.w
w..www......w
w...........w
w.......w...w
ww......w+..w
w...w.w.w.w.w
w...A.......w
wwwwwwwwwwwww
