wwwwwwwwwwwww
w.3......w..w
w..w........w
w...w...w.+ww
w...ww..wwwww
w.......w.g.w
w.w.........w
wA....w.....w
wwwwwwwwwwwww
