wwwwwwwwwwwww
w.3.gw....1.w
w...ww......w
w..........ww
w.......ww.ww
ww......3+..w
w..w..w.w...w
w...A.......w
wwwwwwwwwwwww
