wwwwwwwwwwwww
w..3.ww....Aw
w....w......w
w.w.....www.w
w+w.........w
w.w..wwwwww.w
w.......w...w
w...ww....wgw
wwwwwwwwwwwww
