wwwwwwwwwwwww
w..........Aw
w....w......w
w.w.w....wwgw
w+w........1w
w.1..w.ww.w.w
w..w....w...w
w...w.......w
wwwwwwwwwwwww
