wwwwwwwwwwwww
w..........gw
w....w......w
w.w.w..1w..ww
w+w........ww
ww1..w..3...w
w..w..w...w.w
w...A.......w
wwwwwwwwwwwww
