wwwwwwwwwwwww
w...gw....1.w
w...ww......w
w.w........ww
w.......wwwww
www.....w+..w
w.......w...w
w...A.......w
wwwwwwwwwwwww
