wwwwwwwwwwwww
w..........Aw
w....w......w
w.w.....wwwgw
w+w........1w
w.1..wwwwww.w
w.......w...w
w...ww....w.w
wwwwwwwwwwwww
