wwwwwwwwwwwww
w....w.....gw
w....w......w
w.w....1w...w
w+w.........w
w.1..wwwwww.w
w.......w...w
w...Aw......w
wwwwwwwwwwwww
