wwwwwwwwwwwww
w.3.g.....w.w
w..www......w
w...........w
w.......w...w
w.......w+..w
w...w.w.w.w.w
wA..w.......w
wwwwwwwwwwwww
