wwwwwwwwwwwww
w.3.gw....w.w
w..www......w
w...........w
w.......ww.ww
w.......w+..w
w...w...w...w
wA..w.......w
wwwwwwwwwwwww
