wwwwwwwwwwwww
w....w.....gw
w....w......w
w.w....1....w
w+w.........w
w.1..ww.3...w
w.......w...w
w...A.......w
wwwwwwwwwwwww
