wwwwwwwwwwwww
wA.......w..w
w...........w
w...w...w.+ww
www.ww...wwww
ww......w.g.w
w.w.........w
w.....w.....w
wwwwwwwwwwwww
