wwwwwwwwwwwww
w..........Aw
w....w......w
w.w.w..1.w.ww
w+w........1w
w.w..w.www..w
w.......w...w
w...ww....wgw
wwwwwwwwwwwww
