wwwwwwwwwwwww
w..3..w....Aw
w....w......w
w.w.....wwwgw
w+w........1w
w.w..wwww.www
w.......w...w
w...w.......w
wwwwwwwwwwwww
