wwwwwwwwwwwww
w....ww....Aw
w....w......w
w.w.w...wwwww
w+w........1w
w.w..wwwwwwww
w.......w...w
w...ww....wgw
wwwwwwwwwwwww
