wwwwwwwwwwwww
wA..g.......w
w..w........w
w..........ww
w.......wwwww
w.......w+..w
w.w.........w
w.....w.....w
wwwwwwwwwwwww
