wwwwwwwwwwwww
w.........1gw
w....w......w
w.w.w..1....w
w+w........ww
ww1..w..3...w
w..w..w.w.w.w
w...A.......w
wwwwwwwwwwwww
