wwwwwwwwwwwww
w..3.......Aw
w....w......w
w.w.....wwwgw
w+w........1w
w.w..wwwwwwww
w.......w...w
w...w.......w
wwwwwwwwwwwww
