wwwwwwwwwwwww
wA3.gw....1.w
w..ww.......w
w..........ww
ww..w...wwwww
w.......w+..w
w.w.........w
w.....w.....w
wwwwwwwwwwwww
