wwwwwwwwwwwww
w..........Aw
w....w......w
w.w.w....wwgw
w+w.........w
w.w..w.ww.w.w
w..w....w...w
w...w.......w
wwwwwwwwwwwww
