wwwwwwwwwwwww
w..........Aw
w....w......w
w.w.w....wwgw
w+w........1w
w.1..w.wwww.w
w.......w...w
w...ww......w
wwwwwwwwwwwww
