wwwwwwwwwwwww
w.3.gw...w..w
w..w........w
w..........ww
ww..w...wwwww
w.......w+..w
w...w...w...w
wA..........w
wwwwwwwwwwwww
