wwwwwwwwwwwww
w..........Aw
w....w......w
w.w.w......gw
w+w........1w
w.w..wwwwww.w
w.......w...w
w...ww......w
wwwwwwwwwwwww
