wwwwwwwwwwwww
w..........gw
w....w......w
w.w.w.......w
w+w.....w...w
ww1.....w...w
w.....w.w.w.w
w...A.......w
wwwwwwwwwwwww
