wwwwwwwwwwwww
wA.......w..w
w..w........w
w...w...w.+.w
www.ww..wwwww
www.....w.g.w
w.w.........w
w.....w.....w
wwwwwwwwwwwww
