wwwwwwwwwwwww
wA.......w.gw
w...........w
w.w.w.......w
w+w.........w
ww1..w..w...w
w.....w...w.w
w.....w.....w
wwwwwwwwwwwww
