wwwwwwwwwwwww
w..........Aw
w....w......w
w.w......wwgw
w+w.........w
w.w..wwwwww.w
w.......w.w.w
w...ww....w.w
wwwwwwwwwwwww
