wwwwwwwwwwwww
w...gw....1.w
w...ww......w
w...w......ww
w.......wwwww
ww1.....3+..w
w..w..w.w...w
w...A.......w
wwwwwwwwwwwww
