wwwwwwwwwwwww
w..........Aw
w....w......w
w.w.w...wwwww
w+w........1w
w.1..w.wwwwww
w..w....w...w
w...ww....wgw
wwwwwwwwwwwww
