wwwwwwwwwwwww
wA.......w..w
w..w........w
w.w.w...w.+ww
www.ww..wwwww
www.....w.g.w
w.w.........w
w.....w.....w
wwwwwwwwwwwww
