wwwwwwwwwwwww
w........w.gw
w...........w
w.w.w...w...w
w+w........ww
ww1..w..w...w
w..w..w.....w
w...A.......w
wwwwwwwwwwwww
