wwwwwwwwwwwww
w.....w....gw
w....w......w
w.w.......w.w
w+w.........w
w.w..wwww.w.w
w.......w...w
w...A.......w
wwwwwwwwwwwww
