wwwwwwwwwwwww
w..........Aw
w....w......w
w.w.w..1.w.gw
w+w.........w
w.w..w..w...w
w.......w...w
w...w.......w
wwwwwwwwwwwww
