wwwwwwwwwwwww
w.3.gw....1.w
w..www......w
w..........ww
w........wwww
ww......w+..w
w..w..w.w.w.w
w...A.......w
wwwwwwwwwwwww
