wwwwwwwwwwwww
w........w..w
w....w......w
w.w.w..1w..ww
w+w......wwww
ww1..w..3.g.w
w..w..w.w...w
w...A.......w
wwwwwwwwwwwww
