wwwwwwwwwwwww
w...gw....1.w
w...ww......w
w..........ww
w........wwww
ww......3+..w
w..w..w.w...w
w...A.......w
wwwwwwwwwwwww
