wwwwwwwwwwwww
w..........gw
w....w......w
w.w.w..1....w
w+w.........w
ww1.....3...w
w..w..w.w.w.w
w...A.......w
wwwwwwwwwwwww
