wwwwwwwwwwwww
w...gw....1.w
w...ww......w
w.w........ww
w.......ww.ww
ww......w+..w
w..w..w.w...w
w...A.......w
wwwwwwwwwwwww
