wwwwwwwwwwwww
wA.........gw
w..w........w
w.w.w.......w
w+w.ww......w
ww1..w..w...w
w.....w...w.w
w.....w.....w
wwwwwwwwwwwww
