wwwwwwwwwwwww
w..........Aw
w....w......w
w.w.w.....wgw
w+w.........w
w.w..w.ww.w.w
w.......w.w.w
w...w.......w
wwwwwwwwwwwww
