wwwwwwwwwwwww
w...g.....w.w
w....w......w
w...........w
w.......wwwww
w.......w+..w
w...w...w.w.w
wA..w.......w
wwwwwwwwwwwww
