wwwwwwwwwwwww
w.....w....Aw
w....w......w
w.w.w..1w.wgw
w+w.........w
w.w..w.ww.w.w
w.......w...w
w...ww....w.w
wwwwwwwwwwwww
