wwwwwwwwwwwww
w.....w....Aw
w....w......w
w.w....1.wwgw
w+w........1w
w.w..w.www..w
w.......w...w
w...w.......w
wwwwwwwwwwwww
