wwwwwwwwwwwww
w....w....1gw
w....w......w
w.w.w......ww
w.......w..ww
www.....w+..w
w.......w...w
w...A.......w
wwwwwwwwwwwww
