wwwwwwwwwwwww
wA3......w..w
w..w........w
w.......w.+ww
ww..ww..wwwww
w.......w.g.w
w...........w
w.....w.....w
wwwwwwwwwwwww
