wwwwwwwwwwwww
w..........Aw
w....w......w
w.w.......wgw
w+w.........w
w.1..wwwwww.w
w.......w...w
w...ww......w
wwwwwwwwwwwww
