wwwwwwwwwwwww
w..3..w....Aw
w....w......w
w.w.....w.wgw
w+w.........w
w.w..wwwwww.w
w.......w...w
w...ww....w.w
wwwwwwwwwwwww
