wwwwwwwwwwwww
w.3.gw...w..w
w..w........w
w.......w.+ww
w...w...wwwww
w.......w...w
w...w.......w
wA..........w
wwwwwwwwwwwww
