wwwwwwwwwwwww
wA.......w..w
w...........w
w...w...w.+ww
www.ww.....ww
ww1..w..w.g.w
w.w.......w.w
w.....w.....w
wwwwwwwwwwwww
