wwwwwwwwwwwww
w.3.gw...w..w
w..ww.......w
w.........+ww
w.......wwwww
w.......w...w
w...w.......w
wA..w.w.....w
wwwwwwwwwwwww
