wwwwwwwwwwwww
w..3.ww.w..Aw
w...ww......w
w........wwww
w+w........1w
w.w....wwwwww
w.w.w...w...w
w...ww....wgw
wwwwwwwwwwwww
