wwwwwwwwwwwww
wA.......w..w
w..w........w
w.......w.+ww
www.ww..wwwww
w.......w.g.w
w.w.w.......w
w...........w
wwwwwwwwwwwww
