wwwwwwwwwwwww
wA3..w......w
w..w........w
w.......w.+ww
w.w.w...wwwww
w.......w.g.w
w.w.........w
w.....w.....w
wwwwwwwwwwwww
