wwwwwwwwwwwww
w..3..w....Aw
w....w......w
w.w.......wgw
w+w.........w
w.w..wwww.w.w
w.......w.w.w
w...w.......w
wwwwwwwwwwwww
