wwwwwwwwwwwww
w........w..w
w..w........w
w...w...w.+ww
w.......wwwww
w.......w.g.w
w...........w
wA..........w
wwwwwwwwwwwww
