wwwwwwwwwwwww
w.3.gw...w..w
w..www......w
w..........ww
w.......wwwww
w.......w+..w
w...w...w...w
wA..w.......w
wwwwwwwwwwwww
