wwwwwwwwwwwww
w..........Aw
w....w......w
w.w.....wwwgw
w+w........1w
w.1..w.wwww.w
w.......w...w
w...w.....w.w
wwwwwwwwwwwww
