wwwwwwwwwwwww
w.3.gw....1.w
w..www......w
w..........ww
w.......wwwww
ww......w+..w
w.......w...w
wA..w.......w
wwwwwwwwwwwww
