wwwwwwwwwwwww
w.3.gw....1.w
w..www......w
w..........ww
w.......w..ww
ww......w+..w
w.......w...w
w...A.......w
wwwwwwwwwwwww
