wwwwwwwwwwwww
w.3.g.....1.w
w..ww.......w
w..........ww
w.......wwwww
w.......w+..w
w.......w...w
wA..w.w.....w
wwwwwwwwwwwww
