wwwwwwwwwwwww
w.....w....Aw
w....w......w
w.w......wwgw
w+w........1w
w.w..w.w3ww.w
w.......w...w
w...w.......w
wwwwwwwwwwwww
