wwwwwwwwwwwww
w.....w....Aw
w....w......w
w.w.w....wwgw
w+w........1w
w.w..w.wwww.w
w.......w...w
w...ww......w
wwwwwwwwwwwww
