wwwwwwwwwwwww
w...gw....1.w
w..www......w
w..........ww
w.......wwwww
www.....w+..w
w...w...w...w
wA..w.......w
wwwwwwwwwwwww
