wwwwwwwwwwwww
wA3.g....w..w
w..w........w
w.........+ww
ww......wwwww
w.......w...w
w.w.........w
w...........w
wwwwwwwwwwwww
