wwwwwwwwwwwww
w..3..w....Aw
w....w......w
w.w.w...wwwww
w+w........1w
w.1..wwwwwwww
w.......w...w
w...ww....wgw
wwwwwwwwwwwww
