wwwwwwwwwwwww
w...g.....1.w
w..www......w
w.w.w.......w
w.......w..ww
www.....w+..w
w.....w.w...w
w...A.......w
wwwwwwwwwwwww
