wwwwwwwwwwwww
w....w....1gw
w...ww......w
w.w.w......ww
w+.........ww
ww1.....3...w
w..w..w.w.w.w
w...A.......w
wwwwwwwwwwwww
