wwwwwwwwwwwww
w...gw....1.w
w....w......w
w.w.w......ww
w........wwww
ww......w+..w
w.......w...w
w...A.......w
wwwwwwwwwwwww
