wwwwwwwwwwwww
wA.......w..w
w..w........w
w...w.....+ww
ww..ww..wwwww
w.......w.g.w
w.w.........w
w.....w.....w
wwwwwwwwwwwww
