wwwwwwwwwwwww
w.3.gw....1.w
w..www......w
w..........ww
w.......wwwww
w.......w+..w
w...w...w...w
wA..w.......w
wwwwwwwwwwwww
