wwwwwwwwwwwww
w...gw....1.w
w..www......w
w.w.w......ww
w.......ww.ww
ww1.....w+..w
w..w..w.w...w
w...A.......w
wwwwwwwwwwwww
