wwwwwwwwwwwww
w..3.ww....Aw
w....w......w
w.w.....www.w
w+w........1w
w.w..wwwwwwww
w.......w...w
w...ww....wgw
wwwwwwwwwwwww
