wwwwwwwwwwwww
w...gw...w..w
w..w........w
w..........ww
w.......wwwww
w.w.....w+..w
w.......w...w
wA..w.......w
wwwwwwwwwwwww
