wwwwwwwwwwwww
w..........gw
w...ww......w
w.w.w.......w
w+w.........w
ww......3...w
w..w..w.w.w.w
w...A.......w
wwwwwwwwwwwww
