wwwwwwwwwwwww
w.........wgw
w...ww......w
w.w.w.......w
w+..........w
ww1.....w...w
w..w..w.w.w.w
w...A.......w
wwwwwwwwwwwww
