wwwwwwwwwwwww
w....w.....gw
w....w......w
w.w.........w
w+w.........w
w.1..ww.www.w
w.......w...w
w...Aw......w
wwwwwwwwwwwww
