wwwwwwwwwwwww
w.3.g.....1.w
w..www......w
w..........ww
w.......wwwww
ww......w+..w
w...w.w.w...w
w...A.......w
wwwwwwwwwwwww
