wwwwwwwwwwwww
w....w.....gw
w....w......w
w.w.....www.w
w+w........1w
ww1..w.www.ww
w.......w...w
w...A.......w
wwwwwwwwwwwww
