wwwwwwwwwwwww
w.........1gw
w...ww......w
w.w.w.......w
w.......w...w
www.....w+..w
w.....w.w...w
w...A.......w
wwwwwwwwwwwww
