wwwwwwwwwwwww
w..........Aw
w....w......w
w.w.w...wwwgw
w+w........1w
w.w..w.wwwwww
w.......w...w
w...w.......w
wwwwwwwwwwwww
