wwwwwwwwwwwww
w..3.w.....gw
w....w......w
w.w....1w...w
w+w.........w
ww1..www3...w
w.......w.w.w
w...Aw......w
wwwwwwwwwwwww
