wwwwwwwwwwwww
w..3.......Aw
w....w......w
w.w.....wwwgw
w+w.........w
w.w..wwwwww.w
w.......w...w
w...ww......w
wwwwwwwwwwwww
