wwwwwwwwwwwww
w...gw....1.w
w...ww......w
w..........ww
w.......wwwww
ww......w+..w
w..w....w...w
w...A.......w
wwwwwwwwwwwww
