wwwwwwwwwwwww
w..3..w....Aw
w....w......w
w.w.....wwwww
w+w........1w
w.w..wwwwwwww
w.......w...w
w...ww.....gw
wwwwwwwwwwwww
