wwwwwwwwwwwww
wA.......w..w
w..w........w
w.......w.+ww
w....w..wwwww
w.......w.g.w
w.w.........w
w...........w
wwwwwwwwwwwww
