wwwwwwwwwwwww
w..3.......gw
w....w......w
w.w....1w...w
w+w.........w
w.1..www3w..w
w.......w.w.w
w...Aw......w
wwwwwwwwwwwww
