wwwwwwwwwwwww
w..3.w.....Aw
w....w......w
w.w.....wwwww
w+w........1w
w.w..w.wwwwww
w.......w...w
w...ww....wgw
wwwwwwwwwwwww
