wwwwwwwwwwwww
w..3.......Aw
w....w......w
w.w.....www.w
w+w........1w
w.w..wwwwww.w
w.......w...w
w...ww....wgw
wwwwwwwwwwwww
