wwwwwwwwwwwww
w...g.....1.w
w...ww......w
w...........w
w...........w
w.......w+..w
w...w...w.w.w
wA..w.......w
wwwwwwwwwwwww
