wwwwwwwwwwwww
wA.......w..w
w...........w
w...w...w.+ww
www.ww..wwwww
ww......w.g.w
w.w...w...w.w
w.....w.....w
wwwwwwwwwwwww
