wwwwwwwwwwwww
w.....w....Aw
w....w......w
w.w.w..1...gw
w+w........1w
w.w..w.w3ww.w
w.......w...w
w...ww......w
wwwwwwwwwwwww
