wwwwwwwwwwwww
w...gw....1.w
w..w.w......w
w.w.w......ww
w.......wwwww
ww......w+..w
w.......w...w
w...A.......w
wwwwwwwwwwwww
