wwwwwwwwwwwww
w.....w....Aw
w....w......w
w.w.w..1..wgw
w+w........1w
w.w..w..3ww.w
w.......w...w
w...ww......w
wwwwwwwwwwwww
