wwwwwwwwwwwww
w.....w....Aw
w....w......w
w.w......w.gw
w+w.........w
w.w..w.wwww.w
w.......w...w
w...ww......w
wwwwwwwwwwwww
