wwwwwwwwwwwww
w.....w....Aw
w....w......w
w.w.....wwwgw
w+w........1w
w.w..w.wwww.w
w.......w...w
w...w.....w.w
wwwwwwwwwwwww
