wwwwwwwwwwwww
w.3.gw....1.w
w..www......w
w...w......ww
w.......wwwww
ww1.....w+..w
w..w....w...w
w...A.......w
wwwwwwwwwwwww
