wwwwwwwwwwwww
w..........Aw
w....w......w
w.w.w....wwww
w+w........1w
w.w..w.wwww.w
w.......w...w
w...ww....wgw
wwwwwwwwwwwww
