wwwwwwwwwwwww
w..3..w....Aw
w....w......w
w.w.....wwwgw
w+w.........w
w.w..wwww.w.w
w.......w...w
w...ww....w.w
wwwwwwwwwwwww
