wwwwwwwwwwwww
wA.......w..w
w..w........w
w.w.w...w..ww
w+w.....wwwww
www.....w.g.w
w...........w
w.....w.....w
wwwwwwwwwwwww
