wwwwwwwwwwwww
w..3.......Aw
w....w......w
w.w.....ww.gw
w+w........1w
w.w..wwwwww.w
w.......w...w
w...ww......w
wwwwwwwwwwwww
