wwwwwwwwwwwww
w....w.....gw
w....w......w
w...w..1...ww
w+w........ww
ww...w..3...w
w.....w.w.w.w
w...A.......w
wwwwwwwwwwwww
