wwwwwwwwwwwww
wA..gw....1.w
w..ww.......w
w..........ww
w...w...wwwww
w.......w+..w
w.w.w...w...w
w.....w.....w
wwwwwwwwwwwww
