wwwwwwwwwwwww
wA.......w.gw
w...........w
w...w...w...w
w+w.ww..wwwww
ww......w...w
w.w.........w
w.....w.....w
wwwwwwwwwwwww
