wwwwwwwwwwwww
wA.......w.gw
w...........w
w...w...w.+.w
www.ww......w
ww......w...w
w.w.......w.w
w.....w.....w
wwwwwwwwwwwww
