wwwwwwwwwwwww
w.....w....Aw
w....w......w
w.w......wwgw
w+w........1w
w.1..wwww.w.w
w.......w...w
w...w.....w.w
wwwwwwwwwwwww
