wwwwwwwwwwwww
wA.......w..w
w..w........w
w...w...w.+ww
www.ww..w.w.w
ww......w.g.w
w.w...w...w.w
w.....w.....w
wwwwwwwwwwwww
