wwwwwwwwwwwww
wA.......w..w
w..w........w
w...w...w.+ww
ww..w...wwwww
w.......w.g.w
w.w.........w
w...........w
wwwwwwwwwwwww
