wwwwwwwwwwwww
w.+...A.w.g.w
w.......w.w.w
w...........w
w....w......w
w...........w
w....w......w
w...........w
wwwwwwwwwwwww
