wwwwwwwwwwwww
w..w2w......w
w.w..w1.w...w
ww.......ww.w
w....w.w+w..w
w1.w...wwA..w
w.......w.www
w.gwww2...www
wwwwwwwwwwwww
