wwwwwwwwwwwww
w...........w
w...1+....3.w
w..w........w
w..w.....ww.w
w..w..Ag....w
w...........w
w.....w..2..w
wwwwwwwwwwwww
