wwwwwwwwwwwww
w...........w
w.....w.....w
w.....w.....w
w...A....w..w
w..wwww..w..w
w........w.+w
wwwg..wwwwwww
wwwwwwwwwwwww
