wwwwwwwwwwwww
wg........www
w...........w
w....w......w
w...........w
w....w......w
w.A..w...+..w
w....w......w
wwwwwwwwwwwww
