wwwwwwwwwwwww
w.....ww.+www
www...1..w.Aw
w.ww.......ww
w.ww...1....w
www........1w
wg...www.ww.w
www.........w
wwwwwwwwwwwww
