wwwwwwwwwwwww
w...w...w.A.w
w.w..1w...w.w
w.w...w..3w.w
wgw..www..w.w
w.w...w..ww.w
w...2.w.ww..w
w.....w..+..w
wwwwwwwwwwwww
